----------
-----XXX--
@---#*-X-O
-----XXX--
----------
