@---^-------^---XXXXXXX--XXXXXXX-X--------X------X----X---X---X---X--X-X-X-X-X-X-X-X-X-X--###-----XXX---##--##--^^^XXX####XXX----
----X---#---X----XXXXX----XXXXX--X--------X------X----X---X---X---X--X-X-X-X-X-X-X-X-X-X--###-----XXX---##--##--^^^XXX####XXX----
----X-------X-----XXX------XXX---X--------X------X----X---X---X---X--X-X-X-X-X-X-X-X-X-X--###-----XXX---##--##--^^^XXX####XXX----
----X-------X-----#####----------X--------X------X----X---X---X---X--X-X-X-X-X-X-X-X-X-X--###-----XXX---##--##--^^^XXX####XXX----
^^^^X---*---X-----#####----------X--------X------X----X---X---X---X--X-X-X-X-X-X-X-X-X-X--###-----XXX---##--##--^^^XXX####XXX----
----XXXXXXXXX-----#####-----#----X--------X------X----X---X---X---X--X-X-X-X-X-X-X-X-X-X--###-----XXX---##--##--^^^XXX####XXX----
----X---*---X-----#####----------X--------X------X----X---X---X---X--X-X-X-X-X-X-X-X-X-X--###-----XXX---##--##--^^^XXX####XXX----
----X-------X-----#####----------X--------X------X----X---X---X---X--X-X-X-X-X-X-X-X-X-X--###-----XXX---##--##--^^^XXX####XXX----
----X-------X-----XXX##----XXX---X--------X------X----X---X---X---X--X-X-X-X-X-X-X-X-X-X--###-----XXX---##--##--^^^XXX####XXX----
----X---#---X----XXXXX----XXXXX--X--------X------X----X---X---X---X--X-X-X-X-X-X-X-X-X-X--###-----XXX---##--##--^^^XXX####XXX----
----^-------^---XXXXXXX--XXXXXXX-X--------X------X----X---X---X---X--X-X-X-X-X-X-X-X-X-X--###-----XXX---##--##--^^^XXX####XXX---O
