@---^-------^---XXXXXXX--XXXXXXX-X--
----X---#---X----XXXXX----XXXXX--X--
----X-------X-----XXX------XXX---X--
----X-------X-----#####----------X--
^^^^X---*---X-----#####----------X--
----XXXXXXXXX-----#####-----#----X--
----X---*---X-----#####----------X--
----X-------X-----#####----------X--
----X-------X-----XXX##----XXX---X--
----X---#---X----XXXXX----XXXXX--X--
----^-------^---XXXXXXX--XXXXXXX-X-O
