------XX--X
------XX---
------XX---
------XX---
------XX---
X-----XX---
X-----XX---
X-----XXX--
X-------X--
-----------
----------X
