@----^X-#~
------X--X
XXXX-----X
---------^
~-----X--O
