-------X----------------X---XX------
------XX-----------#--XXX---XX------
----------#X----------------XX------
----XX---XXX----XXX---------XX------
----XX-----------#X---------XX------
----XX----XX---------XXXX---XXXX----
----XX----XX--^--^---*-#X-----XX----
----XX---------------XXXX-----XX----
----XX----^---^--#------------------
----XX------^--------^-------^------
----XX-------------^---^--*--^------