---------
--X------
-XX------
----^----
-#-*-----
---------
-XX-^----
--X------
---------
-----*---