--------^---^---X-----
---XX----------XX-----
---XX--XX-------------
-------XX------XXXX---
---XX----------*-#X---
---XX----------XXXX---
-------XXXX-----------
-------X#-*---XX------
---*---XXXX---XX------
-----X--------XX------
----XX----------------