------------^---^--------*-----------------
XX---XX-------^-----------XX---XX---XX-----
XX---XX---XX----XX--------XX---XX---XX-----
XX-#-XX---XX----XX-------------------------
XX---XX------XX-----XX-^--XX---XX--^---^---
XX---XX------XX-----XX----XX---XX----^-----
---------XX-------#------------------------
--XX-----XX---------XX---------------------
--XX-----------XX-------XX------XX---XX----
---------------XX---^----X------X----XX----
--*-#-------------^---^--------------------