-------------------------------------XX---XX---
------XX----------^---^---^----------XX---XX---
------X----XX--XX---X-X---#----------XX---XX---
-----------XX--XX---X-X--------------XX---XX---
--------------------XXX-----^--------XX---XX---
--------#-----^---^-------^--------XXXX---XX---
--------------------XX------^------XX-----XX---
--------XX---#------XX----^---^----------------
---XX----X----------------------------^--------
---XX----------X--------XX----------^----XX----
---------------XX-------XX---------------XX----