-----------XX--XX----------------^----------XX------
----X*X----XX--XX---XXX*XXX----^-----XXX--XXXX------
----X-X--------XX---XXXXXXX----------XXX--XX--------
XX--X#X--------XX---XXXXXXX---XXX----XXX--XX--------
XX--XXX--------XX---XXXXXXX-----X----XXX--XX--------
-----------XXX------XXXXXXX-------------------------
-----------X#X---X----XXX-----^---^---^---^---^-----
XX------^--X-X---XX---XXX-----------^---^---^-------
XX----^----X*X--------XXX----XXX--------------------
----^---^-------^-----XXX---XXXXX----#-------#------
--^---^-------^---^---XXX--XXXXXXX------------------