----------
----------
^--XX-----
---XX-----
^---------
-----XX---
^----XX---
-#---XX---
--X--XX---
--XX------
-----^----