----------------*---
----XX--------------
----X#------XX------
------------#X------
--------------------
----XX--------------
----XX----XX---XX---
----------XX---XX---
------^---XX-#-XX---
----^---^-XX---XX---
------^---XX---XX---