@------------O-XX
XX---XXXXXXX---XX
XX-----XXX-----XX
XXXX---XXX---XXXX
--XX---XXX---XX--
-------XXX-------
---------------X-
-----X---#X---XX-
----XXX---X------
-#-------^-^-^---
XX~#XX--XX-------