@------------
--XXXX-------
--~-#X-------
--XXXX-------
-^^^^^-------
-------^X--X^
----^XXXXX^--
X~X--XXX#----
X-X--XXX--^-^
X#X--XXX---^-
XXX-------O--