@--------------XX
XX---XXXXXXX---XX
XX-----XXX-----XX
XXXX---XXX---XXXX
---X---XXX---XXX-
-------XXXO------
---X--X--X--X--X-
--X--X-#X-#X---XX
----XXX---X-----X
-#-------^-^-^---
XX*#XX--XX-------