@---^XXXXX
---------X
---XXXX--X
-#-X-----X
--XXO-X--X
----#XX--X
--^------X
--#------X
---XXX----
-*XXXXX---
-XXXXXXX*-