@----^-*
--X----X
--X-#-XX
--X---XX
--X--XXX
-^---XXX
-----XXX
X*X--XXX
X-X--^XX
X#X---#X
XXX--O--