@------^O----------------XX-*-
--XXX-XXX-XXX---#--XXX---XX---
-------#-----------------XX-#-
-X--XXX-XXX-XXX----XXX-#-XX---
-X-----X------#----------XX---
-X-^X--XX---------XXXX---XXX--
-X--X--XXX-^--^-----#X----XX--
--X-X-------------XXXX----XX--
--X----^---^--#-----^^--------
--X------^--------^-^^-^------
--#------------^--^-^^*-^-^---