@--------X-----
XX---^--^X--XXX
XX--XX---X--~-#
----XX------XXX
XX-----^-^--~-#
XX---^------XXX
----XXXXXX--X-O
--X-X-#-~X-XX--
~-X-X--X-X-X---
--X-X----X-X---
XXX---XXXX-----