@-XX-----^-^-^-#-XX----------^----
--XX-^-----------XX-----^--^-*-^--
--XX---XXX-XXX---XX---#------^----
--XX---XXXXXXX---XX-----^--^---^--
--XX---XXXXXXX---XX---XXXXXXXXXXX-
--XX---XXXXXXX---XX----XXXXXXXXX--
--XX----XXXX*---XX------XXXXXXX---
--XXXX---XXX---XXXX---^--XXXXX-#--
----XX---XXX---XX----^^^--XXX-----
-^--#----XXX--------^^^^^------X--
---------XXX---#-----^^^-----XXXOX