@---X---O----------------XX-~-
---XX-----XXX---#--XXX---XX---
-------#-----------------XX-#-
-X--XXX-----XXX----XXX-#-XX---
-X------------#----------XX---
-X--X--XX---------XXXX---XXXX-
-X--X--XX--^--^---~-#X-----XX-
--X-X-------------XXXX-----XX-
--X----^---^--#---------------
--X------^--------^-------^---
--#-------------^---^-~-^---^-