@---^XXXXX
--------OX
---XX----X
-#-XX----X
------X--X
------X--X
--^------X
--#------X
---XXX----
-~XXXXX---
-XXXXXXX~-