@------------
--XXXX----^--
--~-#X--^---^
--XXXX-^--^--
-------------
-------^----^
----^XXXXX^--
X~X--XXX#----
X-X--XXX--^-^
X#X--XXX---^-
XXX-------O--