@---XXX----^--#-^--------*--------------
XX---XX-------^------X---------X---XX*--
XX---XX---XXX---XX---X--XXXX---X-#--X---
XX-#-XX---XXX---XX----------------------
XX---XX----------X--XX-^--XXX----XX--^--
XX---XX--X---XX-----XX------------------
---------XX---X---#------XXX-----XXX----
--XX-----XX---------XX------------------
--XX-----------XX-------XX--^---XX---X--
---------------XX---^----X----^-X----X--
--*-#---XXXX----------^--------------O--