@---XXX----^--#-^--------*--------------
XX---XX-------^------X---------X--XXX*--
XX---XX---XXX----X---X--XXXX---X-#--X---
XX-#-XX---XXX---XXX--X------------------
XX---XX----------X--XX-^--XXXXX--XX--^--
XX---XX--X---XX----XXX------------------
---------XX---XX--#-----XXXX-XXX-XXX----
--XXX----XXX--XXX---XX------------------
-XXXXX---XXXX--XXX------XX--^---XX---X--
--XXX-----------XX--^----X----^-X----X--
--*-#---XXXX----------^--------------O--