@----^-*
--X-----
--X-#-XX
--X---XX
--X-----
-----XX-
-----XX-
X*X-----
X-X---XX
X#X---#X
XXX--O--