--XX---^-^-^-^---XX----------^-------
--XX-------------XX----^---^-*-^-----
--XX---XXX-XXX---XX---#------^-------
--XX---XXXXXXX---XX------------------
--XX---XXXXXXX---XX---XXXXXXXXXXX----
--XX---XXXXXXX---XX----XXXXXXXXX-----
--XX-----XXX-----XX-----XXXXXXX------
--XXXX---XXX---XXX----^--XXXXX-------
----XX---XXX---XX---^-----XXX--------
---------XXX----------^--------------
---------XXX---#----^---^------------