-----^-*---
-----------
----#-XX---
------XX---
-----------
-----XX----
-----XX----
X*X--------
X-X---XX---
X#X---#X---
XXX--------