@--------X-----
XX---^---X--XXX
XX--XX---X--*-#
----XX------XXX
XX-----^-^--*-#
XX---^------XXX
----XXXX-------
----X#-*---XX-O
*---XXXX---XX--
--X------X-XX--
-XX-----XX-----