-XXX-----------XX-----
-X#X-------XX--XX-----
-X-X--X*X--XX--XX-----
-X*X--X-X------XX-----
------X#X------XX-----
------XXX------XX-----
---------------XX-----
-------------XXXX-----
-XXX---^-----XX-------
-XXX-^---^-------#----
-XXX---^---^---^------