@XX-----XX---XXXXXX
-XX-----------XXXX*
-XX-^^^^^------XX--
-XX---*---XXX----#-
-XX-^^^^^---X------
-XX----XXXX----XX--
-XX------------XX--
------XXXXX--------
-^--^-XXX-----XXXOX
--^---XXX--#-------
^--*--XXX-------*--