@-----^---^--------XX-O 
--XX---------XX----XX-- 
--XX--XXXX----X-*--XX-- 
------X#-*--XX-----XX-# 
--XX--XXXX--XX-----XX-- 
-----------------XXXX-- 
---XXXX--XX--XX--XX---- 
-----#X--XX--XX-----^-- 
---XXXX--XX--XX---^---^ 
-^------^XX--XX---XX--- 
------^------*--------- 