@---XXXXXXXXXXXXX--XX-O 
--------#----XX----XX-- 
-XXX--XXXX----X-*--XX-- 
------X#-*--XX-----XX-# 
-XXX--XXXX--XX-----XX-- 
-----------------XXXX-- 
---XXXX--XX--XX--XX---- 
-----#X--XX--XX-----^-- 
---XXXX--XX--XX---^---^ 
-^--^---^XXXXXXXXXXX--- 
------^------*--------- 