@-------------------------------XXXXXXXXX
---XXXXXX-----^----^---^---^-^--XXXXXXXXX
-#-X---*X---XX---XXX---#--------XXXXXXXXX
---X-X--X---XX--XXXXX--------X----XX-^--O
-X-X----X--------XXX-^---^---X----XX---^-
-X---#-----------------^-----X--XXXX-^---
-X---X--X--X-----XX--^---^---X--XXX------
-X----X-*X#--X---XX----^---^-X----------X
-X---X--X--X----------X------X--^--^---XX
-X----#--------------XX------X---^----XXX
-*---------------------------X------XXXXX