@-XXX----------XX-O
--X#X-X----X---XX--
--X-X-X----X---XX-#
--X~X-X-#--X---XX--
------X-~--X---XX--
-^---^XXXXXX---XX--
---^--X----X---XX--
-^---^---^-#-XXXX--
XXXX---^-----XX----
XXXX-^-~-^-#-^---#-
XXXX---^---^-~-^---