@XX-----XX---XXXXXX
-XX-----------XXXX*
-XX-^---^------XX--
-XX---*----XX----#-
-XX-^---^---X------
-XX----XXX-----XX--
-XX------------XX--
------XXXX---------
^---^-XX------XXXOX
--^---XX---#-------
^--*--XX--------*--