@---XX-~XX---------------^---^--~
--------XX----XXXXXXX-XX--XX-----
--XX--#-XX----XXXXXXX-XX---X-----
--------XX--^------------X--^--^-
--XX----XX----^XX---XX--XXX------
--XX--#-XX--^--XX---XX---#--^----
^-XX----XX----^XX---------^---^--
--XX-----------XX-XX--XXXX---X---
--XX-^--XXX----XX-XX--XX-#---XXO-
--XX---XXXXX---XX-----XX---------
--XX--XXXXXXX--XX-----XX----~-XXX