@----------XX--XX------------------------------XX
----X~X----XX--XX---XXX~XXX----^---^-XX--XX--XXXX
----X-X----X---XX---XXXXXXX------^---XX--XX~-XX--
XX--X#X----X-#-XX---XXXXXXX---XXX----XX--XX--XX--
XX--XXX--------XX-#-XXXXXXX------#---XX--XX#-XX--
-----------XXX------XXXXXXX---------^------------
-----------X#X---X----XXX-----^--^---^XXXX------
XXX-----^--X-X---XX---XXX------------------------
------^----X~X--------XXX-#--XXX-------------#---
----^---^-------^-----XXX---XXXXX----#-----------
--^---^-------^---^---XXX-~XXXXXXX------------O--