@-XXX----------XX-O
--X#X------XX--XX--
--X-X-X~X--XX--XX-#
--X~X-X-X------XX--
------X#X--X---XX--
-^----XXX-XX---XX--
---^--X----X---XX--
-----^---^-#-XXXX--
XXXX---^-----XX----
XXXX-^-~-^-#-----#-
XXXX---^---^-~-^---