@---#----
--X--XX--
O-XX-XX--
--XX----X
^-XX----X
----#----
^--XXX---
---XXX--~
XX--^---#
~X----^--
----^---^