@---------------------------------XX---XX
---XX----------^---^---^---^-^----XX---XX
-#-X---~XX--XX---X-X---#----------XX---XX
-----X--XX--XX---X-X---------X----XX-^--O
-XX--------------XXX-^---^---X----XX---^-
-----#-----^---^-------^-----X--XXXX-^---
-----------------XX--^---^------XX-------
-X---XX-~-#------XX----^---^-------------
XXX---X----------------------------^----X
-X----#-----X--^---^-XX----------^----XXX
-~----------XX-------XX------X--------XX-