@---#----
--X---XX-
O-XX---XX
^-XXX---X
--XXXX--X
----#----
^--XXX---
^^-XXX--~
XX----^-#
~X---^^^-
----^^^^^