@-----X------~
-XXX--X---XX--
--#---X---XX--
--X--XX--#----
--X--X----^^^^
--X--X-----XXX
--X--X-XX---XX
-------XX---XX
---^---XX-#-XX
-^---^-XX---XX
---^-~-XX-O-XX