@-----X------~
-XX---X---XX--
-X#---X---XX--
-----XX--#----
---------^---^
-XX--X----XXXX
-XX--X-XX---XX
-------XX---XX
---^---XX-#-XX
-^---^-XX---XX
---^-~-XX-O-XX