-&---^-*-----------*---------^-*--------*---------^-*-----#---^-*---
-^-------------------XX--^----------------XX--^-----------X-----&---
----#-XX-------&-----XX-----#-XX----&-----XX-----#-XX-----X--#-XX---
------XX-------^--------------XX----^--------------XX-----X----XX---
XX----&-------^^^-------XX---------^^^-------XX-----------X---------
XX---XX---#--^^^^^------XX---XX---^^^^^------XX---XX---#--X---XX---#
-----XX-------^^^------------XX----^^^------------XX------X---XX----
X*X------------^---XX---X*X---------^---XX---X*X----------X---------
X-X---XX-------&---XX---X-X---XX----&---XX---X-X---XX-----X----XX---
X#X---#X----------------X#X---#X-------------X#X---#X-----X----#X---
XXX-------*-------------XXX------------------XXX-------*&-X--------*
