------^---XX---
----------XX---
-----XX---XX---
---#-XX---XX---
--------X-XX---
--------X-XX---
----^-----XX---
----#-----XX---
-----XXX-------
----XXXXX------
---XXXXXXX-*---