-----------
----X------
---XX------
------^----
---#-*-----
-----------
---XX-^----
----X------
-----------
-----------
-------*---