---XX---XXXXXXX---XX---
---XX---XXXXXXX---XX---
---XX-----XXX-----XX---
---XXXX---XXX---XXXX---
-----XX---XXX---XX-----
----------XXX----------
----------XXX-----X----
--------X--------XX----
--------XX-------------
-----------XX----^-----
-----*-#---XX------^---