-------------------
-----XXXX----^-----
-----*-#X--^---^---
-----XXXX----^-----
-------------------
-------------------
---------XX--------
---X*X---XX--------
---X-X---XX--------
---X#X---XX--------
---XXX---XX--------