-----------------*---------^---^------
----------XXX------XX---XX---XX-------
----------XXX------XX---XX---XX-------
----------XXX-^------------------^----
----XX----XXX-------------------------
----XX----XXX--^---------------^------
----XX----XXX---------------^---^-----
----XX----XXX----XX-----XX------------
----XX----XXX----XX-----XX------------
----XX---XXXXX----------XX--------X---
----XX--XXXXXXX---------XX----*-XXX---