-------^---^--------XX-----
---XX---------------XX-----
---XX--XXXX------*--XX-----
-------X#-*---XX----XX-----
-------XXXX---XX----XX-----
------------------XXXX-----
----XXXX--XX------XX-------
------#X--XX---------------
----XXXX--XX---XX----------
----------XX---XX----------
---------------------------