-------------
----XX--^----
----XX-------
-------------
----X--XX----
---XX--XX----
-------------
---XX--X*X---
---*X--X-X---
-------X#X---
-------XXX---